R 1366 768

NO ./textures/north.xpm
SO ./textures/south.xpm
WE ./textures/west.xpm
EA ./textures/east.xpm

S ./textures/pillar.xpm
P ./textures/barrel.xpm

F ./textures/floor.xpm
C ./textures/cloud.xpm


1111111111111111
1111000000001111
1110000330000111
1100000000000011
1100000220000011
1100000000000011
1110000000000111
1111000000001111
11100000000000111
1111111001111111111111111111111111111111111111111111111111111111
1000000003000000000000000000000000000000000000000000000020000001
10000000000000000000000000000000000000000000000000000000000000011
11111111111001111111111111111110011111111111111111001111111111111
1000000000000000000000000000000000000000000000000000000000000001
1100111111100000022000000000000000000000003000000000003300000001
1100111111100000000000000000000001111111100002111100000000000001
11000021111000000000000003300000011111111000031111000000000000011
11000021111000000000000000000000011111111001111111000000000000011
11111111111000000000000000000000011111111001111111000000000000211
111111111110011111111111111111100111111110011111110000000000000111
1000000000000000000000000200000000000000000000000000000000000001
10000000000000000000000000000000000000000000000300000000000000011
11111111111001111111111111111110011111111111111111001111111111111
11111111111201111111111111111110311111111111111111201111111111111
11111111111001111111111111111110011111111111111111001111111111111
11111111111001111111111111111100111111111111111111001111111111111
1000000000000000003300000000000000000000000000000000000000000001
1000000000000000000000000000000000000000000000000000000000000001
1000020000000000000000000000000000000000000022000000000000000001
1000000000000000000000002000000000000000000000000000000000000001
1000000000000000000000000000000000000000000000000000000000000001
1111111111100111111111111111111111111111111111111001111111111111
1111111111100111111111111111111111111111111111111001111111111111
1111111111100111111111111111111111111111111111111001111111111111
1111111111100111111111111111111111111111111111111001111111111111
1000000033000000000000000000000022000000000000000000000000000001
1000000000000000000000000000000000000000000000000000000000000001
1000000000000000000000000000000000000000000000000000000000000001
1000000200000000000000000030000000000000000000000000000000000001
10000000000000000000000000000000000N0000000000000000000000300001
1111111111111111111111111111111111111111111111111111111111111111
