R 1366 768

NO ./textures/no.xpm
SO ./textures/so.xpm
WE ./textures/we.xpm
EA ./textures/ea.xpm

S ./textures/pillar.xpm
P ./textures/barrel.xpm

F ./textures/floor.xpm
C ./textures/cloud.xpm

    111111111111111111111111111111
    11100000000211000000000000111
    11111011000001110000000000001
    100100000000000000000000111111
111111111011000001110000000010001
100000000011000001110111111111111
11110111111111011100000010001
111101111111110111010100100011
11000000112121011100000010001
10000000000000000111000010201
1E0000000000000011 1010010001
100000000000000011 1010010001
1100000011012121111121111000111
11112111 1112121 101111010001
11111111 1111111 111111111111
